NO  ./textures/green.xpm
SO ./textures/purple.xpm
WE ./textures/orange.xpm
EA ./textures/red.xpm
        
C 126,220,233
F 255,242,204

1111111111111111111111111
   110000000001100000000111
1111000001110000000000001
1000000000000000S0000000111111111
111111111011000001110000000000001
100000000000000001110111111111111
11110111111111011100000010001
11110111110101011101010000001
11000000110101011100000000001
10000000000000000000000010001
10000000000000000001010010001
1100000111010101111000111000111
11110111 1110101 100001000001
11111111 1111111 111111111111
