NO  ./textures/bricks.xpm
SO ./textures/grass.xpm
WE ./textures/plank.xpm
EA ./textures/honey.xpm

C 205,249,255
F 186,193,61

  1111 111
  10011101   
  10011101
  1000S001
  11111111