

    WE            ./textures/purple.xpm

EA            ./textures/red.xpm

      NO  ./textures/green.xpm

  SO ./textures/orange.xpm
        
C 126  ,   220   ,   233
F         255           ,242    ,   204


111111111111
111000000001
 100S0001111 
 10001111 
111111