

    WE            ./textures/purple.xpm

EA            ./textures/red.xpm

      NO  ./textures/green.xpm

  SO ./textures/orange.xpm
        
C 126  ,   220   ,   233
F         255           ,242    ,   204


                   1
                  111
                 11011
                1100011
               111000111
              11000S00011
             1111000001111
            110000000000011
           11000000000000011
          1100000000000000011
         110000000000000000011
        11000000000000000000011
       1100000000000000000000011
      110000000000000000000000011
     11000000000000000000000000011
    1100000000000000000000000000011
   110000000000000000000000000000011
  11000000000000000000000000000000011
 1100000000000000000000000000000000011
111111111111111111111111111111111111111
