NO  ./textures/planks.xpm
SO ./textures/cobblestone_01.xpm
WE ./textures/basalt_top.xpm
EA ./textures/wall2.xpm
        
F  0,120,0
C  0,0,120

01111111111111
10000000000001
100010N0100001
10001000111001
11111111111111